itsjustaburningmemory = itsjustaburningmemoryName
frozenintime = frozenintimeName
rememberingtheworldasitusedtobe = rememberingtheworldasitusedtobeName
apokatastasisi = apokatastasisiName
marchofthepriests = marchofthepriestsName
apokatastasisii = apokatastasisiiName
passing = passingName
thehermit = thehermitName
aesthetic = aestheticName
nekrosis = nekrosisName
ecstaticparadigm = ecstaticparadigmName
heosphoros = heosphorosName
illuminatio = illuminatioName
thylight = thylightName
sacrumnoctis = sacrumnoctisName
chaliceofeternity = chaliceofeternityName
abedofashes = abedofashesName
afaintlightonthesurface = afaintlightonthesurfaceName
falseidols = falseidolsName
quicksand = quicksandName
smokeandmirrors = smokeandmirrorsName
thedaywhenyoulostyoursmile = thedaywhenyoulostyoursmileName
threadbare = threadbareName
youdisappeared = youdisappearedName
aseductionofmalice = aseductionofmaliceName
boundtomemory = boundtomemoryName
deceivedbyshelter = deceivedbyshelterName
entangledinmortar = entangledinmortarName
hauntedbywhispers = hauntedbywhispersName
inthecompanyofruin = inthecompanyofruinName
lonesomehallsofruin = lonesomehallsofruinName
remnantsofthemissing = remnantsofthemissingName
thecollectorsharvest = thecollectorsharvestName
theeternalveil = theeternalveilName
themanifestation = themanifestationName
intro = introName
dream = dreamName
baba = babaName
greenpeople = greenpeopleName
roadtohome = roadtohomeName
untitled1 = untitled1Name
firstvisit = firstvisitName
heartbeat = heartbeatName
piotrek = piotrekName
untitled2 = untitled2Name
wedding = weddingName
untitled3 = untitled3Name
wolf = wolfName
voices = voicesName
lasthideout = lasthideoutName
atheatreofshadows = atheatreofshadowsName
cursedridersofthenight = cursedridersofthenightName
parlourofignorance = parlourofignoranceName
thecrossing = thecrossingName
theunforgivingtolloffame = theunforgivingtolloffameName
vagrantsouls = vagrantsoulsName
beyondthelimit = beyondthelimitName
adoorbeyondperception = adoorbeyondperceptionName
coldsleuthing = coldsleuthingName
eyesofblack = eyesofblackName
mindlesswanderftzenjungle = mindlesswanderftzenjungleName
nothingbutdustftkimguy = nothingbutdustftkimguyName
strangersreflection = strangersreflectionName
twilightreverie = twilightreverieName
twistoftime = twistoftimeName
endofthenight = endofthenightName
whattheearthbore = whattheearthboreName
thedeadfire = thedeadfireName
burrows = burrowsName
echo = echoName
inanarchedworld = inanarchedworldName
omission = omissionName
eschatology = eschatologyName
drawnlikeamoth = drawnlikeamothName
alldreamsmined = alldreamsminedName
immemorial = immemorialName
onesatoptheunknown = onesatoptheunknownName
nightsoclosetothetongue = nightsoclosetothetongueName
alonelystrain = alonelystrainName
aphotic = aphoticName
cavernofigneousflame = cavernofigneousflameName
onyx = onyxName
apalesignrevealed = apalesignrevealedName
avenoir = avenoirName
ancientamulet = ancientamuletName
unveilingthescript = unveilingthescriptName
deepspacesignals = deepspacesignalsName
consternation = consternationName
activating = activatingName
iridescenceshimmer = iridescenceshimmerName
theplanet = theplanetName
induction = inductionName
nascency = nascencyName
roadtonowhere = roadtonowhereName
solarhalos = solarhalosName
beyondtheedge = beyondtheedgeName
echosphere = echosphereName
brokenworlds = brokenworldsName
losthorizon = losthorizonName
overland = overlandName
oceangrooves = oceangroovesName
reverseechoes = reverseechoesName
deltazero = deltazeroName
spellbound = spellboundName
intothevoid = intothevoidName
paralleldestiny = paralleldestinyName
ancientpillars = ancientpillarsName
particlestorm = particlestormName
floatingspheres = floatingspheresName
aphoticblack = aphoticblackName
becomingonewithdarkness = becomingonewithdarknessName
eternaldrift = eternaldriftName
herebutnothere = herebutnothereName
nebulousbeings = nebulousbeingsName
surrender = surrenderName
suspendedconsciousness = suspendedconsciousnessName
theslowagonyofsolitude = theslowagonyofsolitudeName
threnody = threnodyName
chiaroscuro = chiaroscuroName
ghostsmarchinghome = ghostsmarchinghomeName
lastcall = lastcallName
livesinreverse = livesinreverseName
memoriesofanoldcity = memoriesofanoldcityName
nowayoutofthismaze = nowayoutofthismazeName
obscuration = obscurationName
relics = relicsName
sundown = sundownName
thedarkestnightever = thedarkestnighteverName
theperilsofdawn = theperilsofdawnName
atransientshelter = atransientshelterName
latenightatthelastresort = latenightatthelastresortName
opiateddreams = opiateddreamsName
redcurtains = redcurtainsName
thedarknessbeforemyeyes = thedarknessbeforemyeyesName
thesadnessofallthings = thesadnessofallthingsName
exodus = exodusName
lightsout = lightsoutName
paleconquerors = paleconquerorsName
passageintooblivion = passageintooblivionName
quietus = quietusName
slowmotiondownfall = slowmotiondownfallName
spectralparade = spectralparadeName
taintedcity = taintedcityName
thedesolationage = thedesolationageName
thecelestialcity = thecelestialcityName
onlystringsandtheirsupportsremain = onlystringsandtheirsupportsremainName
totalperspectivevortex = totalperspectivevortexName
themerchantsofsevennations = themerchantsofsevennationsName
nothingofthecitytouchestheearth = nothingofthecitytouchestheearthName
desiresarealreadymemories = desiresarealreadymemoriesName
everysolsticeequinox = everysolsticeequinoxName
thedeadoutnumbertheliving = thedeadoutnumberthelivingName
thirteenthcenturytravelogue = thirteenthcenturytravelogueName
despairdialogue = despairdialogueName
sothatthecitycanbegintoexist = sothatthecitycanbegintoexistName
thedividedcity = thedividedcityName
